!Map!
_______________________________________________________________________________________________________________________^%
______________________________________________________________________________________________________________________^^%
___________________________________________________________________________________________________________________^^^^%
___________________________________________________________________________________________________________________^^^^^%
__________________________________________________________________________________________________________________^^^^^^%
_______________________________________________________________________________________________________________^^^^^^^^^%
____________~~~~~___~___~~~~~____~~~~~___~~~~~___~~~~~_______________________________________________________^^^^^^^^^^^%
______________~_____~___~________~_______~___~___~________________________________________________________^^^^^^^^^^^^^^%
______________~_____~___~___~~___~~~_____~~~~~___~~~~~_________________________________________________^^^^^^^^^^^^^^^^^%
______________~_____~___~___~____~_______~__~________~________________________________________________^^^^^^^^^^^^^^^^^^%
______________~_____~___~~~~~____~~~~~___~___~___~~~~~______________________________________________^^^^^^^^^^^^^^^^^^^~%
__________________________________________________________________________________________________^^^^^^^^^^^^^^^^^~~~~~%
______________________________________________________________________________________________^^^^^^^^^^^^^^^^^^~~~~~~^^%
_____________________________________________________________________________________________^^^^^^^^^^^^^^^^^~~~~~^^^^^%
___________________________________________________________________________________________^^^^^^^^^^^^^^^^~~~~~^^^^^^^^%
_______________________________________________________________________________________^^^^^^^^^^^^^^^^^~~~~~~^^^^^^^^^^%
_____________________________________________________________________________________^^^^^^^^^^^^^^^^^~~~~~^^^^^^^^^^^^^%
__________________________________________________________________________________^^^^^^^^^^^^^^^^^~~~~~^^^^^^^^^^^^^^^^%
_________________________________________________________________________________^^^^^^^^^^^^^^^^^~~~^^^^^^^^^^^^^^^^^^^%
________________________________________________________________________________^^^^^^^^^^^^^^^^^~~^^^^^^^^^^^^^^^^^^^^^%
_______________________________________________________________________________^^^^^^^^^^^^^^^^~~~^^^^^^^^^^^^^^^^^^^^^^%
____________________________________________________________________________^^^^^^^^^^^^^^^^^~~~^^^^^^^^^^^^^^^^^^^^^^^^%
___________________________________________________________________________^^^^^^^^^^^^^^^^^~~^^^^^^^^^^^^^^^^^^^^^^^^^^%
___________________________________________________________________________^^^^^^^^^^^^^^^^~~^^^^^^^^^^^^^^^^^^^^^^^^^^^%
___________________________________________________________________________^^^^^^^^^^^^^^~~~^^^^^^^^^^^^^^^^^^^^^^^^^^^^%
__________________________________________________________________________^^^^^^^^^^^^^^~~^^^^^^^^^^^^^^^^^^^^^^^^^^^^^^%
_________________________________________________________________________^^^^^^^^^^^^^~~~^^^^^^^^^^^^^^^^^^^^^^^^^^^^^^^%
_________________________________________________________________________^^^^^^^^^^^~~~^^^^^^^^^^^^^^^^^^^^^^^^^^^^^^^^^%
________________________________________________________________________^^^^^^^^^^^~~~^^^^^^^^^^^^^^^^^^^^^^^^^^^^^^^^^^%
______________________________________________________________________^^^^^^^^^^^^~~^^^^^^^^^^^^^^^^^^^^^^^^^^^^^^^^^^^^%
____________________________________________________________________^^^^^^^^^^^^~~~^^^^^^^^^^^^^^^^^^^^^^^^^^^^^^^^^^^^^%
__________________________________________________________________^^^^^^^^^^^^^^~~^^^^^^^^^^^^^^^^^^^^^^^^^^^^^^^^^^^^^^%
_______________________________________________________________^^^^^^^^^^^^^^^~~~^^^^^^^^^^^^^^^^^^^^^^^^^^^^^^^^^^^^^^^%
____________________________________________________________^^^^^^^^^^^^^^^^^~~^^^^^^^^^^^^^^^^^^^^^^^^^^^^^^^^^^^^^^^^^%
___________________________________________________________^^^^^^^^^^^^^^^^^^~~^^^^^^^^^^^^^^^^^^^^^^^^^^^^^^^^^^^^^^^^^%
________________________________________________________^^^^^^^^^^^^^^^^^^^^~~^^^^^^^^^^^^^^^^^^^^^^^^^^^^^^^^^^^^^^^^^^%
______________________________________________________^^^^^^^^^^^^^^^^^^^^^~~^^^^^^^^^^^^^^^^^^^^^^^^^^^^^^^^^^^^^^^^^^^%
__________________________________________________________________________~~____________________________________________%
_________________________________________________________________________~~~____________________________________________%
________________________________________________________________________~~~_____________________________________________%
________________________________________________________________________~~______________________________________________%
________________________________________________________________________~~~_____________________________________________%
_________________________________________________________________________~~~____________________________________________%
_________________________________________________________________________~~~____________________________________________%
_________________________________________________________________________~~~____________________________________________%
_________________________________________________________________________~~_____________________________________________%
________________________________________________________________________~~~_____________________________________________%
_______________________________________________________________________~~_______________________________________________%
______________________________________________________________________~~________________________________________________%
______________________________________________________________________~~________________________________________________%
_____________________________________________________________________~~_________________________________________________%
____________________________________________________________________~~__________________________________________________%
____________________________________________________________________~~__________________________________________________%
_____________________________________________________________________~~_________________________________________________%
_____________________________________________________________________~~_________________________________________________%
____________________________________________________________________~~__________________________________________________%
___________________________________________________________________~~___________________________________________________%
__________________________________________________________________~~____________________________________________________%
_________________________________________________________________~~_____________________________________________________%
________________________________________~~~~~__________________~~~______________________________________________________%
______________________________________~~~~~~~~~~~_____________~~________________________________________________________%
___________________________________~~~~~~~~~~~~~~~____________~~~_______________________________________________________%
________________________________~~~~~~~~~~~~~~~~~~~___________~~________________________________________________________%
____________________________~~~~~~~~~~~~~~~~~~~~~~~~~~~~~~~~~~~~________________________________________________________%
_______________________~~~~~~~~~~~~~~~~~~~~~~~~~~~~~~~~~~~~~~~~~~~~~~~__________________________________________________%
_____________________~~~~~~~~~~~~~~~~~~~~~~~~~~~~~~~~~~~~~~~~~~~~~~~~~~~________________________________________________%
__________________~~~~~~~~~~~~~~~~~~~~~~~~~~~~~~~~~~~~~~~~~~~~~~~~~~~~~~~~______________________________________________%
__________________~~~~~~~~~~~~~~~~~~~~~~~~~~~~~~~~~~~~~~~~~~~~~~~~~~~~__________________________________________________%
_________________~~~~~~~~~~~~~~~~~~~~~~~~~~~~~~~~~~~~~~~~~~~~~~~~~______________________________________________________%
________________~~~~~~~~~~~~~~~~~~~~~~~~~~~~~~~~~~~~~~~~~~~~~~~~~_______________________________________________________%
__________________~~~~~~~~~~~~~~~~~~~~~~~~~~~~~~~~~~~~~~~~~~~~~~~_______________________________________________________%
____________________~~~~~~~~~~~~~~~~~~~~~~~~~~~~~~~~~~~~~~~~~~~~~~~~____________________________________________________%
______________________~~~~~~~~~~~~~~~~~~~~~~~~~~~~~~~~~~~~~~~~~~~~~~____________________________________________________%
_________________________~~~~~~~~~~~~~~~~~~~~~~~~~~~~~~~~~~~~~__________________________________________________________%
_______________________________~~~~~~~~~~~~~~~~~~~~~~~~~~_______________________________________________________________%
____________________________________~~~~~~~~~~~~~~~~~___________________________________________________________________%
________________________________________~~~~~___________________________________________________________________________%
________________________________________________________________________________________________________________________%
________________________________________________________________________________________________________________________%
________________________________________________________________________________________________________________________%
________________________________________________________________________________________________________________________%
________________________________________________________________________________________________________________________%
________________________________________________________________________________________________________________________%
________________________________________________________________________________________________________________________%
________________________________________________________________________________________________________________________%
________________________________________________________________________________________________________________________%
________________________________________________________________________________________________________________________%
________________________________________________________________________________________________________________________%
________________________________________________________________________________________________________________________%
________________________________________________________________________________________________________________________%
!Decals!
RED_CROSS;2,3%
SKULL_AND_CROSSBONES;20,23%
GOLD_STAR;12,57%
SKULL_AND_CROSSBONES;12,7%
!Items on map!
oneShot;37,47%
interactive;48,61%
obstacle;31,48%
obstacle;31,49%
obstacle;31,50%
obstacle;31,51%
obstacle;31,52%
obstacle;31,53%
!Takeable items on map!
1,2;4;1;5;2;7;1%
83,31;4;1;5;2;7;1%
56,100;4;1;5;2;7;1%
70,4;4;1;5;2;7;1%
!Area effects!
healDamage;2,3-20%
instantDeath;20,23%
levelUp;12,57%
takeDamage;12,7-10%
!Entities!
0;13,23;SMASHER;10;4;3;11;5;84;99;3;64%
!Items in inventory!
E10;3;1;3;4;1%
0;2;4;1;2;1%
EE2;4;2;1;1;1%
