!Map!
_______________________________________________________________________________________________________________________^%
______________________________________________________________________________________________________________________^^%
____________________________________________________________________________________________________________________^^^^%
___________________________________________________________________________________________________________________^^^^^%
__________________________________________________________________________________________________________________^^^^^^%
_______________________________________________________________________________________________________________^^^^^^^^^%
____________~~~~~___~___~~~~~____~~~~~___~~~~~___~~~~~_______________________________________________________^^^^^^^^^^^%
______________~_____~___~________~_______~___~___~________________________________________________________^^^^^^^^^^^^^^%
______________~_____~___~__~~____~~~_____~~~~~___~~~~~_________________________________________________^^^^^^^^^^^^^^^^^%
______________~_____~___~___~____~_______~__~________~________________________________________________^^^^^^^^^^^^^^^^^^%
______________~_____~___~~~~~____~~~~~___~___~___~~~~~______________________________________________^^^^^^^^^^^^^^^^^^^~%
__________________________________________________________________________________________________^^^^^^^^^^^^^^^^^~~~~~%
______________________________________________________________________________________________^^^^^^^^^^^^^^^^^^~~~~~~^^%
_________________________________________________________~~__________________________________^^^^^^^^^^^^^^^^^~~~~~^^^^^%
______________________________________________________~~~~~________________________________^^^^^^^^^^^^^^^^~~~~~^^^^^^^^%
______________________________________________________~~~~_____________________________^^^^^^^^^^^^^^^^^~~~~~~^^^^^^^^^^%
_______________________________________________________~~~___________________________^^^^^^^^^^^^^^^^^~~~~~^^^^^^^^^^^^^%
______________________________________________________~~__________________________^^^^^^^^^^^^^^^^^~~~~~^^^^^^^^^^^^^^^^%
______________________________________________________~~_________________________^^^^^^^^^^^^^^^^^~~~^^^^^^^^^^^^^^^^^^^%
_____________________________________________________~~_________________________^^^^^^^^^^^^^^^^^~~^^^^^^^^^^^^^^^^^^^^^%
____________________________________________________~~~________________________^^^^^^^^^^^^^^^^~~~^^^^^^^^^^^^^^^^^^^^^^%
_____________________________________________________~~~____________________^^^^^^^^^^^^^^^^^~~~^^^^^^^^^^^^^^^^^^^^^^^^%
______________________________________________________~~___________________^^^^^^^^^^^^^^^^^~~^^^^^^^^^^^^^^^^^^^^^^^^^^%
_______________________________________________________~~__________________^^^^^^^^^^^^^^^^~~^^^^^^^^^^^^^^^^^^^^^^^^^^^%
_______________________________________________________~~__________________^^^^^^^^^^^^^^~~~^^^^^^^^^^^^^^^^^^^^^^^^^^^^%
______________________________________________________~~__________________^^^^^^^^^^^^^^~~^^^^^^^^^^^^^^^^^^^^^^^^^^^^^^%
_____________________________________________________~~__________________^^^^^^^^^^^^^~~~^^^^^^^^^^^^^^^^^^^^^^^^^^^^^^^%
____________________________________________________~~___________________^^^^^^^^^^^~~~^^^^^^^^^^^^^^^^^^^^^^^^^^^^^^^^^%
___________________________________________________~~___________________^^^^^^^^^^^~~~^^^^^^^^^^^^^^^^^^^^^^^^^^^^^^^^^^%
__________________________________________________~~__________________^^^^^^^^^^^^~~^^^^^^^^^^^^^^^^^^^^^^^^^^^^^^^^^^^^%
__________________________________________________~~________________^^^^^^^^^^^^~~~^^^^^^^^^^^^^^^^^^^^^^^^^^^^^^^^^^^^^%
_________________________________________________~~_______________^^^^^^^^^^^^^^~~^^^^^^^^^^^^^^^^^^^^^^^^^^^^^^^^^^^^^^%
________________________________________________~~_____________^^^^^^^^^^^^^^^~~~^^^^^^^^^^^^^^^^^^^^^^^^^^^^^^^^^^^^^^^%
________________________________________________~~__________^^^^^^^^^^^^^^^^^~~^^^^^^^^^^^^^^^^^^^^^^^^^^^^^^^^^^^^^^^^^%
_________________________________________________~~________^^^^^^^^^^^^^^^^^^~~^^^^^^^^^^^^^^^^^^^^^^^^^^^^^^^^^^^^^^^^^%
__________________________________________________~~____^^^^^^^^^^^^^^^^^^^^~~^^^^^^^^^^^^^^^^^^^^^^^^^^^^^^^^^^^^^^^^^^%
___________________________________________________~~_^^^^^^^^^^^^^^^^^^^^^~~^^^^^^^^^^^^^^^^^^^^^^^^^^^^^^^^^^^^^^^^^^^%
____________________________________________________~~____________________~~____________________________________________%
_____________________________________________________~~~_________________~~~____________________________________________%
_______________________________________________________~~~~~~~~~~_______~~~_____________________________________________%
_________________________________________________________~~~~~~~~~~~~~__~~______________________________________________%
__________________________________________________________________~~~~~~~~~_____________________________________________%
______________________________________________________________________~~~~~~____________________________________________%
_________________________________________________________________________~~~____________________________________________%
_________________________________________________________________________~~~____________________________________________%
_________________________________________________________________________~~_____________________________________________%
________________________________________________________________________~~~_____________________________________________%
_______________________________^^^_____________________________________~~_______________________________________________%
______________________________^^^^___^^_______________________________~~________________________________________________%
____________________________^^____^^^_________________________________~~________________________________________________%
________________________^^^^______^^^^_______________________________~~_________________________________________________%
________________________^_______^^_______^^_________________________~~__________________________________________________%
_________________________^__^^______^^^^____________________________~~__________________________________________________%
_______________________^^_^_______^___^^_____________________________~~_________________________________________________%
________________________________^______^_____________________________~~_________________________________________________%
____________________________________________________________________~~__________________________________________________%
___________________________________________________________________~~___________________________________________________%
__________________________________________________________________~~____________________________________________________%
_________________________________________________________________~~_____________________________________________________%
________________________________________~~~~~__________________~~~______________________________________________________%
______________________________________~~~~~~~~~~~_____________~~________________________________________________________%
___________________________________~~~~~~~~~~~~~~~____________~~~_______________________________________________________%
________________________________~~~~~~~~~~~~~~~~~~~___________~~________________________________________________________%
____________________________~~~~~~~~~~~~~~~~~~~~~~~~~~~~~~~~~~~~________________________________________________________%
_______________________~~~~~~~~~~~~~~~~~~~~~~~~~~~~~~~~~~~~~~~~~~~~~~~__________________________________________________%
_____________________~~~~~~~~~~~~~~~~~~~~~~~~~~~~~~~~~~~~~~~~~~~~~~~~~~~________________________________________________%
__________________~~~~~~~~~~~~~~~~~~~~~~~~~~~~~~~~~~~~~~~~~~~~~~~~~~~~~~~~______________________________________________%
__________________~~~~~~~~~~~~~~~~~~~~~~~~~~~~~~~~~~~~~~~~~~~~~~~~~~~~__________________________________________________%
_________________~~~~~~~~~~~~~~~~~~~~~~~~~~~~~~~~~~~~~~~~~~~~~~~~~______________________________________________________%
________________~~~~~~~~~~~~~~~~~~~~~~~~~~~~~~~~~~~~~~~~~~~~~~~~~_______________________________________________________%
__________________~~~~~~~~~~~~~~~~~~~~~~~~~~~~~~~~~~~~~~~~~~~~~~~_______________________________________________________%
____________________~~~~~~~~~~~~~~~~~~~~~~~~~~~~~~~~~~~~~~~~~~~~~~~~____________________________________________________%
______________________~~~~~~~~~~~~~~~~~~~~~~~~~~~~~~~~~~~~~~~~~~~~~~____________________________________________________%
_________________________~~~~~~~~~~~~~~~~~~~~~~~~~~~~~~~~~~~~~__________________________________________________________%
_______________________________~~~~~~~~~~~~~~~~~~~~~~~~~~_______________________________________________________________%
____________________________________~~~~~~~~~~~~~~~~~___________________________________________________________________%
________________________________________~~~~~___________________________________________________________________________%
________________________________________________________________________________________________________________________%
________________________________________________________________________________________________________________________%
________________________________________________________________________________________________________________________%
________________________________________________________________________________________________________________________%
________________________________________________________________________________________________________________________%
________________________________________________________________________________________________________________________%
________________________________________________________________________________________________________________________%
________________________________________________________________________________________________________________________%
________________________________________________________________________________________________________________________%
________________________________________________________________________________________________________________________%
________________________________________________________________________________________________________________________%
________________________________________________________________________________________________________________________%
________________________________________________________________________________________________________________________%
!Decals!
RED_CROSS;2,3%
RED_CROSS;62,30%
RED_CROSS;82,83%
SKULL_AND_CROSSBONES;20,23%
SKULL_AND_CROSSBONES;89,5%
GOLD_STAR;12,57%
GOLD_STAR;89,119%
GOLD_STAR;40,107%
SKULL_AND_CROSSBONES;12,7%
SKULL_AND_CROSSBONES;13,24%
SKULL_AND_CROSSBONES;80,100%
SKULL_AND_CROSSBONES;5,90%
!Items on map!
oneShot;37,47%
oneShot;88,90%
oneShot;75,12%
oneShot;48,110%
interactive;48,61%
interactive;19,4%
interactive;50,107%
interactive;88,79%
interactive;80,37%
obstacle;31,30%
obstacle;31,31%
obstacle;31,32%
obstacle;31,33%
obstacle;31,34%
obstacle;31,35%
!Takeable items on map!
Sword;E1,2;4;1;5;2;7;1%
Potion;83,31;4;1;5;2;7;1%
Shield;E56,100;4;1;5;2;7;1%
Staff;E70,4;4;1;5;2;7;1%
Coins;38,40;0;2;4;1;2;1%
Axe;E27,24;2;4;2;1;1;1%
Map;9,32;0;0;0;0;0;0%
Telescope;65,5;0;0;0;0;0;0%
!Area effects!
healDamage;2,3-20%
healDamage;62,30-10%
healDamage;82,83-40%
instantDeath;20,23%
instantDeath;89,5%
levelUp;12,57%
levelUp;89,119%
levelUp;40,107%
takeDamage;12,7-10%
takeDamage;13,24-10%
takeDamage;80,100-20%
takeDamage;5,90-30%
!Entities!
90;13,23;SMASHER;10;4;3;11;5;84;240;3;64%
!Items in inventory!
Tiger Costume;E10;3;1;3;4;1%
