!Map!
______________________________________________________________________________________________________________________^%
_____________________________________________________________________________________________________________________^^%
___________________________________________________________________________________________________________________^^^^%
__________________________________________________________________________________________________________________^^^^^%
_________________________________________________________________________________________________________________^^^^^^%
______________________________________________________________________________________________________________^^^^^^^^^%
___________~~~~~___~___~~~~~____~~~~~___~~~~~___~~~~~_______________________________________________________^^^^^^^^^^^%
_____________~_____~___~________~_______~___~___~________________________________________________________^^^^^^^^^^^^^^%
_____________~_____~___~___~~___~~~_____~~~~~___~~~~~_________________________________________________^^^^^^^^^^^^^^^^^%
_____________~_____~___~___~____~_______~__~________~________________________________________________^^^^^^^^^^^^^^^^^^%
_____________~_____~___~~~~~____~~~~~___~___~___~~~~~______________________________________________^^^^^^^^^^^^^^^^^^^~%
_________________________________________________________________________________________________^^^^^^^^^^^^^^^^^~~~~~%
_____________________________________________________________________________________________^^^^^^^^^^^^^^^^^^~~~~~~^^%
____________________________________________________________________________________________^^^^^^^^^^^^^^^^^~~~~~^^^^^%
__________________________________________________________________________________________^^^^^^^^^^^^^^^^~~~~~^^^^^^^^%
______________________________________________________________________________________^^^^^^^^^^^^^^^^^~~~~~~^^^^^^^^^^%
____________________________________________________________________________________^^^^^^^^^^^^^^^^^~~~~~^^^^^^^^^^^^^%
_________________________________________________________________________________^^^^^^^^^^^^^^^^^~~~~~^^^^^^^^^^^^^^^^%
________________________________________________________________________________^^^^^^^^^^^^^^^^^~~~^^^^^^^^^^^^^^^^^^^%
_______________________________________________________________________________^^^^^^^^^^^^^^^^^~~^^^^^^^^^^^^^^^^^^^^^%
______________________________________________________________________________^^^^^^^^^^^^^^^^~~~^^^^^^^^^^^^^^^^^^^^^^%
___________________________________________________________________________^^^^^^^^^^^^^^^^^~~~^^^^^^^^^^^^^^^^^^^^^^^^%
__________________________________________________________________________^^^^^^^^^^^^^^^^^~~^^^^^^^^^^^^^^^^^^^^^^^^^^%
__________________________________________________________________________^^^^^^^^^^^^^^^^~~^^^^^^^^^^^^^^^^^^^^^^^^^^^%
__________________________________________________________________________^^^^^^^^^^^^^^~~~^^^^^^^^^^^^^^^^^^^^^^^^^^^^%
_________________________________________________________________________^^^^^^^^^^^^^^~~^^^^^^^^^^^^^^^^^^^^^^^^^^^^^^%
________________________________________________________________________^^^^^^^^^^^^^~~~^^^^^^^^^^^^^^^^^^^^^^^^^^^^^^^%
________________________________________________________________________^^^^^^^^^^^~~~^^^^^^^^^^^^^^^^^^^^^^^^^^^^^^^^^%
_______________________________________________________________________^^^^^^^^^^^~~~^^^^^^^^^^^^^^^^^^^^^^^^^^^^^^^^^^%
_____________________________________________________________________^^^^^^^^^^^^~~^^^^^^^^^^^^^^^^^^^^^^^^^^^^^^^^^^^^%
___________________________________________________________________^^^^^^^^^^^^~~~^^^^^^^^^^^^^^^^^^^^^^^^^^^^^^^^^^^^^%
_________________________________________________________________^^^^^^^^^^^^^^~~^^^^^^^^^^^^^^^^^^^^^^^^^^^^^^^^^^^^^^%
______________________________________________________________^^^^^^^^^^^^^^^~~~^^^^^^^^^^^^^^^^^^^^^^^^^^^^^^^^^^^^^^^%
___________________________________________________________^^^^^^^^^^^^^^^^^~~^^^^^^^^^^^^^^^^^^^^^^^^^^^^^^^^^^^^^^^^^%
__________________________________________________________^^^^^^^^^^^^^^^^^^~~^^^^^^^^^^^^^^^^^^^^^^^^^^^^^^^^^^^^^^^^^%
_______________________________________________________^^^^^^^^^^^^^^^^^^^^~~^^^^^^^^^^^^^^^^^^^^^^^^^^^^^^^^^^^^^^^^^^%
_____________________________________________________^^^^^^^^^^^^^^^^^^^^^~~^^^^^^^^^^^^^^^^^^^^^^^^^^^^^^^^^^^^^^^^^^^%
_________________________________________________________________________~~____________________________________________%
________________________________________________________________________~~~____________________________________________%
_______________________________________________________________________~~~_____________________________________________%
_______________________________________________________________________~~_____________________________________________ %
_______________________________________________________________________~~~_____________________________________________%
________________________________________________________________________~~~____________________________________________%
________________________________________________________________________~~~____________________________________________%
________________________________________________________________________~~~____________________________________________%
________________________________________________________________________~~_____________________________________________%
_______________________________________________________________________~~~_____________________________________________%
______________________________________________________________________~~_______________________________________________%
_____________________________________________________________________~~________________________________________________%
_____________________________________________________________________~~________________________________________________%
____________________________________________________________________~~_________________________________________________%
___________________________________________________________________~~__________________________________________________%
___________________________________________________________________~~__________________________________________________%
____________________________________________________________________~~_________________________________________________%
____________________________________________________________________~~_________________________________________________%
___________________________________________________________________~~__________________________________________________%
__________________________________________________________________~~___________________________________________________%
_________________________________________________________________~~____________________________________________________%
________________________________________________________________~~_____________________________________________________%
_______________________________________~~~~~__________________~~~______________________________________________________%
_____________________________________~~~~~~~~~~~_____________~~________________________________________________________%
__________________________________~~~~~~~~~~~~~~~____________~~~_______________________________________________________%
_______________________________~~~~~~~~~~~~~~~~~~~___________~~________________________________________________________%
___________________________~~~~~~~~~~~~~~~~~~~~~~~~~~~~~~~~~~~~________________________________________________________%
______________________~~~~~~~~~~~~~~~~~~~~~~~~~~~~~~~~~~~~~~~~~~~~~~~__________________________________________________%
____________________~~~~~~~~~~~~~~~~~~~~~~~~~~~~~~~~~~~~~~~~~~~~~~~~~~~________________________________________________%
_________________~~~~~~~~~~~~~~~~~~~~~~~~~~~~~~~~~~~~~~~~~~~~~~~~~~~~~~~~______________________________________________%
_________________~~~~~~~~~~~~~~~~~~~~~~~~~~~~~~~~~~~~~~~~~~~~~~~~~~~~__________________________________________________%
________________~~~~~~~~~~~~~~~~~~~~~~~~~~~~~~~~~~~~~~~~~~~~~~~~~______________________________________________________%
_______________~~~~~~~~~~~~~~~~~~~~~~~~~~~~~~~~~~~~~~~~~~~~~~~~~_______________________________________________________%
_________________~~~~~~~~~~~~~~~~~~~~~~~~~~~~~~~~~~~~~~~~~~~~~~~_______________________________________________________%
___________________~~~~~~~~~~~~~~~~~~~~~~~~~~~~~~~~~~~~~~~~~~~~~~~~____________________________________________________%
_____________________~~~~~~~~~~~~~~~~~~~~~~~~~~~~~~~~~~~~~~~~~~~~~~____________________________________________________%
________________________~~~~~~~~~~~~~~~~~~~~~~~~~~~~~~~~~~~~~__________________________________________________________%
______________________________~~~~~~~~~~~~~~~~~~~~~~~~~~_______________________________________________________________%
___________________________________~~~~~~~~~~~~~~~~~___________________________________________________________________%
_______________________________________~~~~~___________________________________________________________________________%
_______________________________________________________________________________________________________________________%
_______________________________________________________________________________________________________________________%
_______________________________________________________________________________________________________________________%
_______________________________________________________________________________________________________________________%
_______________________________________________________________________________________________________________________%
_______________________________________________________________________________________________________________________%
_______________________________________________________________________________________________________________________%
_______________________________________________________________________________________________________________________%
_______________________________________________________________________________________________________________________%
_______________________________________________________________________________________________________________________%
_______________________________________________________________________________________________________________________%
_______________________________________________________________________________________________________________________%
_______________________________________________________________________________________________________________________%
!Decals!
RED_CROSS;2,3%
GOLD_STAR;1,1%
SKULL_AND_CROSSBONES;3,0%
!Items on map!
oneShot;0,0%
interactive;2,2%
obstacle;3,3%
!Takeable items on map!
1,2;4;1;5;2;7;1%
!Area effects!
healDamage;1,3,1,1,2,2-20%
takeDamage;0,3-10%
instantDeath;2,1%
levelUp;3,2%
!Entities!
90;0,1;SMASHER;10;4;3;11;5;84;99;3;64%
!Items in inventory!
E10;3;1;3;4;1%
0;2;4;1;2;1%
EE2;4;2;1;1;1%
